#############################################
#A#   #         #   #     #             #   #
# # # # ### ### # # # ### # ####### ### ### #
# # # # #   #     # # #   #         #   #   #
# ### # ### ### ### # # ### ######### # ### #
#     # #   #   #   # #   # #   #   # #     #
# ### # ##### # ### ### ### ### # # # #######
# #       #   #   #   #     # #   # # # #   #
# # ##### ### ### # # ### ### # ##### # # ###
# #     #   #   # # #     #   #       # # ###
# ##### ### ### # # ##### ### ####### # # ###
# #     #   #     #     #   #     #   #   ###
# # # ### # # ##### ### # ### # # # ##### ###
#   # #   #   #       # #     # # #         #
##### ### ##### ### ### ####### # ######### #
#     #         # #   #       # # #       # #
# # ### ####### # ### ####### # ######### # #
# #   #   #     #     #       # #         # #
# ### ### ########### ####### ### ######### #
#   #   #   #   #   # #         #           #
# # # # ### # # # # # # ### ############### #
# #   #     # # # # #   #   #               #
# # # ### ### # # # ##### # ### ########### #
# # #   # #   # # # #   # #     #         # #
# # ##### # ### ### # # # ##### ######### # #
# #       #   #     # #     # #           # #
# ######### # ##### # ##### # ########### # #
#           #     #       # #             #B#
#############################################
